NO ./textures/test/north.xpm
SO ./textures/test/south.xpm
WE ./textures/test/west.xpm
EA ./textures/test/east.xpm

F 0,255,0
C 0,0,255

1111111111
1010000001
10100N0001
1010000101
1000000001
1111111101