NO ./textures/wolfenstein/blue_stone.xpm
SO ./textures/wolfenstein/color_stone.xpm
WE ./textures/wolfenstein/grey_stone.xpm
EA ./textures/wolfenstein/purple_stone.xpm
DO ./textures/wolfenstein/door_blue.xpm

F 66,49,29
C 118,131,135

        1111111111111111111111111
        1000000000110000000000001
        1011000001110000000000001
        1001000000000000000000001
111111111011000001110000000000001
10000000001100000111011111D111111
11110111111111D11100000010001
11110111111111011101010010001
11000000110101011100000010001
10000000000000000000000000001
10000000N00000001101010010001
110000011101D10111110111100111
11110111 1110101 1101111010001
11111111 1111111 111111111111