NO ./textures/wolfenstein/blue_stone.xpm
SO ./textures/wolfenstein/color_stone.xpm
WE ./textures/wolfenstein/grey_stone.xpm
EA ./textures/wolfenstein/purple_stone.xpm
DO ./textures/wolfenstein/door_blue.xpm

F 66,49,29
C 118,131,135

1111111111
1010000001
1010000001
10100S0101
10D0000001
1111111111
